你好，我叫刘婧娇。	Bonjour [à toi], je m'appelle Liú Jìngjiāo.
大家好，我是刘婧娇。	Bonjour tout le monde, je suis Liú Jìngjiāo.
谢谢你。	Merci [à toi].
我家不大。	Ma maison n'est pas grande.
请问，你叫什么名字？	S'il te plaît (litt. puis-je te demander?), tu t'appelles comment? [forme complète]
你叫什么？	Tu t'appelles comment? [forme abrégée]
请问，你家在哪里？	Dis-moi, où est ta maison?
你在哪里？	Où es-tu?
我在家里。	Je suis à la maison.
你是谁？	Qui es-tu?
请坐。	Assieds-toi (poli).
你在家请谁？	Qui invites-tu à la maison?
“五”不是“我”。	« [5] » n'est pas « [je] ».
二零一五年	2015 (année)
二零一五年十月十九日	19 octobre 2015
滚！	Casse-toi!
你好吗？	Comment ça va?
你们在家里吗？	Vous [plur.] êtes à la maison?
我们很好。	Nous allons (très) bien.
十三	13
四十四	44
她二十五岁。	Elle a 25 ans.
你几岁？	Tu as quel âge? (familier, ou enfant)
你多大岁数？	Tu as quel âge? (plus formel)
他们的岁数很大。	Ils sont âgés. (litt. Leur âge est grand [avancé])
我们是你们的朋友。	Nous sommes vos amis (adressé à plusieurs personnes).
她们不是朋友。	Elles ne sont pas amies.
我是你的朋友。	Je suis ton ami(e).
我是学生。	Je suis étudiant(e).
我是一个法国学生。	Je suis un(e) étudiant(e) français(e) (litt. de France).
你是哪国人？	Tu es de quel pays?
我是德国人。	Je suis allemand.
他们在一个法国朋友的家里。	Ils sont chez un ami français (litt. dans la maison d'un ami français).
我的学生们是德国人。	Mes étudiants sont allemands.
我有一个家。	J’ai une famille/maison.
你们是我的学生。	Vous êtes mes étudiants.
我是你们的中文老师。	Je suis votre professeur de chinois.
你们是我的德文老师。	Vous êtes mes professeurs d’allemand.
我们在大学学中文。	Nous apprenons le chinois à l’université.
我是大学的学生。	Je suis étudiant(e) de l’université.
你的家里有几个人？	Il y a combien de personnes dans ta famille ?
法国是中国的朋友。	La France est l’amie de la Chine.
我的生日是十月九日。	Mon anniversaire est le 9 octobre.
我出生于一九九五年六月二日。	Je suis né(e) le 2 juin 1995.
我们不是同学。	Nous ne sommes pas camarades de classe.
老师好。	Bonjour, professeur.
不用谢。	De rien.
闭嘴!	Ta gueule!
